   #######################################################################################
#   ########     # ##  ####  ######         ####         ####         ####         #######
#  ########### ###### # ## # ########## ########  #####  ####  #####  ####  #####  #######
##  ########## ###### ##  ## ########## ########  #####  ####  #####  ####  #####  #######
## ########### ###### ###### ########## ########  #####  ####  #####  ####  #####  #######
##  ########     #### ###### ########## ########         ####         ####         #######
### ######################################################################################
##  ####################  ###########      #####          ####  ######  ########   ##*####
## #####################  ##########  ####  ############  ######  ##  ########## # ## ####
##  ####################  ##########  ####  #######    ###########  ###      ### # ## ####
### ####################  ##########        ####  ################  ###  ##  ### # ## ####
##             #########         ###  ####  ####          ########  ###  ##  ### # ## ####
##       ###  #########################################################  ##  ### # ## ####
###########  #######    ####       ###      ##########     ############  ##  ### # ## ####
#########   #######  ##  ##  #####  ##  ##   #####     ###   #   #   ##  ##  ### # ## ####
#########           ####    ######     #####       #########   #   #     ##      #    ####
##########################################################################################
